55555+5G555+55555+55555+k555 +
55555+ gg  +55g55+55555+ 55  +
55555+5 5g5+55555+55555+    5+
55555+5ggg5+55555+55555+ 5555+
55555+5g555+55555+55555+   55+
++++++++++++++++++++++++++++++
55555+55555+55555+55555+5   k+
55555+55555+55g55+55555+5 555+
55555+55555+55555+55555+     +
55555+55555+55555+55555+5 5 5+
55555+55555+55555+55555+555 5+
++++++++++++++++++++++++++++++
55555+55555+5555 +55555+55555+
55555+55555+55H5 +55555+55555+
55555+55S55+5    +55h55+55 55+
55555+55555+55 55+55555+55555+
55555+55555+5k 5 +55555+55555+
++++++++++++++++++++++++++++++
55555+55555+55555+55555+55555+
55555+55555+55555+55555+55555+
55555+55555+55h55+55555+55555+
55555+55555+55555+55555+55555+
55555+55555+55555+55555+55555+
++++++++++++++++++++++++++++++
 5 5s+55555+55555+55555+55555+
 5 55+55555+55555+55555+55555+
r  g +55 55+55h55+55555+55555+
55 5 +55555+55555+55555+55555+
K5 5 +55555+55555+55555+55555+
++++++++++++++++++++++++++++++
