    +077 +0b7 +077 +
0000+k777+0777+0777+
0000+0777+0777+0777+
0000+0000+0000+0000+
++++++++++++++++++++
0000+00s0+  00+000 +
0000+0000+0000+000 +
0000+0000+0000+0000+
0000+0000+0000+0000+
++++++++++++++++++++
0000+ 0 0+ 000+ 000+
0ggg+0000+0   +0rrr+
0srg+0000+0 99+0999+
0rrg+0000+0   +09 9+
++++++++++++++++++++
0000+   0+0000+ 000+
0999+0000+0999+0999+
0rrr+0000+0 rr+09  +
0rrh+0000+0rrr+0rrr+
++++++++++++++++++++
0000+ 000+ 000+K000+
0rrr+0000+09k +0 9 +
0ggg+0000+09gg+0g99+
0   +0000+0   +0   +
++++++++++++++++++++
0000+  00+0000+0 00+
0000+0000+0000+0 00+
0000+0 00+0000+0000+
0000+0 00+0000+0000+
++++++++++++++++++++
0 00+0 00+0000+0 00+
0000+0000+0   +0000+
0000+0 00+0 00+0000+
0000+0000+0000+0000+
++++++++++++++++++++
 000+0777+0777+0777+
000 +  7 +077 +0777+
0000+0777+0777+0777+
0000+0000+0000+0000+
++++++++++++++++++++
 000+0777+H B7+ 77 +
0   + 777+07G7+0777+
0 00+0S77+0777+0777+
0000+0000+0000+0000+
++++++++++++++++++++
