            +00000 00000 +            +000000000000+000000000000+000000000000+000000000000+000000000000+000000000000+000000000000+000000000000+000000000000+
00000 00000 +000000000000+00000 00000 +000000     0+000000000000+000000000000+000000000000+000000000000+000000000000+000000000000+000000000000+000000000000+
0   0 0   0 +0 0 000 0 00+0   0 0   0 +000000 000 0+000000000000+000000000000+000000000000+0 0000000000+000000000000+000000000000+000000000000+000000000000+
0 0 0 0 0 0 +000000000000+0 0 0 0 0 0 +000000 000 0+000000000000+000000000000+000000000000+000000000000+000000000000+000000000000+000000000000+000000000000+
0   0 0   0 +0 0 000 0 00+0   0 0   0 +000000 000 0+000000000000+000000000000+000000000000+000000000000+000000000000+000000000000+000000000000+000000000000+
00000 00000 +000000000000+00000 00000 +000000     0+000000000000+000000000000+000000000000+000000000000+000000000000+000000000000+000000000000+000000000000+
     S      +00000 00000 +            +000000000000+000000000000+000000000000+000000000000+000000000000+000000000000+000000000000+000000000000+000000000000+
00000 00000 +000000000000+00000 00000 +000000000000+000000000000+000000000000+000000000000+000000000000+000000000000+000000000000+000000000000+000000000000+
0   0 0   0 +0 0 000 0 00+0   0 0   0 +000000000000+000000000000+000000000000+000000000000+000000000000+000000000000+000000000000+000000000000+000000000000+
0 0 0 0 0 0 +000000000000+0 0 0 0 0 0 +000000000000+000000000000+000000000000+000000000000+000000000000+000000000000+000000000000+000000000000+000000000000+
0   0 0   0 +0 0 000 0 00+0   0 0   0 +000000000000+000000000000+000000000000+000000000000+000000000000+000000000000+000000000000+000000000000+000000000000+
00000 00000 +000000000000+00000 00000 +000000000000+000000000000+000000000000+000000000000+000000000000+000000000000+000000000000+000000000000+000000000000+
++++++++++++++++++++++++++++++++++++++++++++++++++++++++++++++++++++++++++++++++++++++++++++++++++++++++++++++++++++++++++++++++++++++++++++++++++++++++++++
00000000h00 +66666 666666+000000000000+000000000000+000000000000+000000000000+000000000000+000000000000+000000000000+000000000000+000000000000+000000000000+
000000000000+00000H000006+000000000000+0000000000 0+000000000000+000000000000+000000000000+000000000000+000000000000+000000000000+000000000000+000000000000+
000000000000+0         06+000000000000+000000000000+000000000000+000000000000+000000000000+0 0000000000+000000000000+000000000000+000000000000+000000000000+
000000000000+0 2222222 06+000000000000+000000000000+000000000000+000000000000+000000000000+000000000000+000000000000+000000000000+000000000000+000000000000+
000000000000+0 2  k  2 06+000000000000+000000000000+000000000000+000000000000+000000000000+000000000000+000000000000+000000000000+000000000000+000000000000+
000000000000+0 2 444 2 06+000000000000+000000000000+000000000000+000000000000+000000000000+000000000000+000000000000+000000000000+000000000000+000000000000+
00000 000000+0 2k4 4k2 06+00000 000000+000000000000+000000000000+000000000000+000000000000+000000000000+000000000000+000000000000+000000000000+000000000000+
000000000000+0 2 444 2 06+000000000000+000000000000+000000000000+000000000000+000000000000+000000000000+000000000000+000000000000+000000000000+000000000000+
000000000000+0 2  k  2 06+000000000000+000000000000+000000000000+000000000000+000000000000+000000000000+000000000000+000000000000+000000000000+000000000000+
000000000000+0 2222222 06+000000000000+000000000000+000000000000+000000000000+000000000000+000000000000+000000000000+000000000000+000000000000+000000000000+
000000000000+0         06+000000000000+000000000000+000000000000+000000000000+000000000000+000000000000+000000000000+000000000000+000000000000+000000000000+
000000000000+000000000006+000000000000+000000000000+000000000000+000000000000+000000000000+000000000000+000000000000+000000000000+000000000000+000000000000+
++++++++++++++++++++++++++++++++++++++++++++++++++++++++++++++++++++++++++++++++++++++++++++++++++++++++++++++++++++++++++++++++++++++++++++++++++++++++++++
     k22k22 +000000000000+00 0 0000 00+000000000000+000000000000+000000000000+000000000000+000000000000+000000000000+000000000000+000000000000+000000000000+
22222222 222+000000000000+00 0 0000 00+0000000000 0+000000000000+000000000000+000000000000+000000000000+000000000000+000000000000+000000000000+000000000000+
22222222 222+000000000000+   0 0      +000000000000+000000000000+000000000000+000000000000+0 0000000000+000000000000+000000000000+000000000000+000000000000+
            +000000000000+0000 0 000 0+000000000000+000000000000+000000000000+000000000000+000000000000+000000000000+000000000000+000000000000+000000000000+
11 111111111+000000000000+ K0    h 0 0+000000000000+000000000000+000000000000+000000000000+000000000000+000000000000+000000000000+000000000000+000000000000+
11 111111111+000000000000+ 00 0000h0 0+000000000000+000000000000+000000000000+000000000000+000000000000+000000000000+000000000000+000000000000+000000000000+
11k11      k+000000000000+    0  h 0 0+000000000000+000000000000+000000000000+000000000000+000000000000+000000000000+000000000000+0000000000G0+000000000000+
11 111111111+000000000000+000 000000 0+000000000000+000000000000+000000000000+000000000000+000000000000+000000000000+000000000000+000000000000+000000000000+
11 111111111+000000000000+00         0+000000000000+000000000000+000000000000+000000000000+000000000000+000000000000+000000000000+000000000000+000000000000+
            +000000000000+00 000000000+000000000000+000000000000+000000000000+000000000000+000000000000+000000000000+000000000000+000000000000+000000000000+
22222222 222+000000000000+   0        +000000000000+000000000000+000000000000+000000000000+000000000000+000000000000+000000000000+000000000000+000000000000+
22222222 222+000000000000+00 0 0000 00+000000000000+000000000000+000000000000+000000000000+000000000000+000000000000+000000000000+000000000000+000000000000+
++++++++++++++++++++++++++++++++++++++++++++++++++++++++++++++++++++++++++++++++++++++++++++++++++++++++++++++++++++++++++++++++++++++++++++++++++++++++++++
000000000000+000000000000+000000000000+000000000000+000000000000+000000000000+000000000000+000000000000+000000000000+000000000000+000000000000+000000000000+
000000000000+000000000000+000000000000+0000000000 0+000000000000+000000000000+000000000000+000000000000+000000000000+000000000000+000000000000+000000000000+
000000000000+000000000000+000000000000+0000000000 0+000000000000+000000000000+000000000000+0 0000000000+000000000000+000000000000+000000000000+000000000000+
000000000000+000000000000+000000000000+000000000000+000000000000+000000000000+000000000000+000000000000+000000000000+000000000000+000000000000+000000000000+
000000000000+000000000000+000000000000+000000000000+0000000000 0+000000000000+000000000000+000000000000+000000000000+000000000000+000000000000+000000000000+
000000000000+000000000000+000000000000+000000000000+000000000000+000000000000+000000000000+000000000000+000000000000+000000000000+000000000000+000000000000+
000000000000+000000000000+000000000000+000000000000+000000000000+0000000000 0+000000000000+000000000000+000000000000+000000000000+0000000000 0+000000000000+
000000000000+000000000000+000000000000+000000000000+000000000000+000000000000+000000000000+000000000000+000000000000+000000000000+000000000000+000000000000+
000000000000+000000000000+000000000000+000000000000+000000000000+000000000000+0000000000 0+000000000000+000000000000+000000000000+000000000000+000000000000+
000000000000+000000000000+000000000000+000000000000+000000000000+000000000000+000000000000+000000000000+000000000000+000000000000+000000000000+000000000000+
000000000000+000000000000+000000000000+000000000000+000000000000+000000000000+000000000000+000000000000+000000000000+000000000000+000000000000+000000000000+
000000000000+000000000000+000000000000+000000000000+000000000000+000000000000+000000000000+000000000000+000000000000+000000000000+000000000000+000000000000+
++++++++++++++++++++++++++++++++++++++++++++++++++++++++++++++++++++++++++++++++++++++++++++++++++++++++++++++++++++++++++++++++++++++++++++++++++++++++++++
            +            +            +            +            +            +            +            +            +         666+         6 6+         666+
         666+         666+         666+         666+         666+            +000         +000         +000         +         666+         6 6+         6 6+
         6 6+         6 6+         6 6+         6 6+         666+            +000         +0 0         +000         +         666+         6 6+         666+
         666+         6 6+         666+         666+         666+         666+000         +000         +000         +         666+         6 6+         666+
         666+         6 6+         6 6+         6 6+         6 6+         666+            +            +            +         666+         6 6+         666+
         666+         6 6+         666+         666+         666+         666+         666+            +            +         666+         6 6+         666+
         666+         6 6+         6 6+         6 6+         6 6+         6 6+         666+            +            +         666+         6 6+         666+
         666+         6 6+         666+         666+         666+         666+         666+         666+            +         666+         6 6+         666+
         666+         6 6+         6 6+         6 6+         6 6+         6 6+         6 6+         666+            +         666+         6 6+         666+
         666+         6 6+         666+         666+         666+         666+         666+         666+         666+         666+         6 6+         666+
         6 6+         6 6+         6 6+         6 6+         6 6+         6 6+         6 6+         6 6+         6 6+         6 6+         6 6+         6 6+
         666+         666+         666+         666+         666+         666+         666+         666+         666+         666+         6 6+         666+
++++++++++++++++++++++++++++++++++++++++++++++++++++++++++++++++++++++++++++++++++++++++++++++++++++++++++++++++++++++++++++++++++++++++++++++++++++++++++++
            +            +            +            +            +            +            +            +            +         666+         666+         666+
         666+         666+         666+         666+000      666+000         +000         +000         +000         +000      666+000      666+000      666+
         666+         6 6+         666+         666+000      666+000         +000         +0 0         +000         +000      666+0 0      666+000      666+
         666+         666+         666+         666+000      666+000      666+000         +000         +000         +000      666+000      666+000      666+
         666+         666+         666+         666+         666+         666+            +            +            +         666+         666+            +
  000    666+  000    666+  000    666+  000    666+  000    666+  000    666+  000    666+            +            +         666+         666+  000    666+
  000    666+  000    666+  000    666+  000    666+  000    666+  000    666+  000    666+            +            +         666+         666+  000    666+
  000    666+  000    666+  000    666+  000    666+  000    666+  000    666+  000    666+         666+            +         666+         666+  000    666+
  000    666+  000    666+  000    666+         666+         666+         666+         666+         666+            +         666+         666+         666+
00000    666+00000    666+00000    666+         666+         666+         666+         666+         666+         666+         666+         666+         666+
00000    666+00000    666+00000    666+         666+         666+         666+         666+         666+         666+         666+         666+         666+
00000    666+00000    666+00000    666+         666+         666+         666+         666+         666+         666+         666+         666+         666+
++++++++++++++++++++++++++++++++++++++++++++++++++++++++++++++++++++++++++++++++++++++++++++++++++++++++++++++++++++++++++++++++++++++++++++++++++++++++++++
            +            +            +            +            +            +            +            +            +            +            +            +
         666+         666+         666+            +000         +000         +000         +000         +000         +000         +0 0         +000         +
         666+         6 6+         666+            +000         +0 0         +0 0         +0 0         +0 0         +0 0         +            +0 0         +
         666+         666+         666+            +000         +000         +000         +000         +000         +000         +0 0         +000         +
            +            +            +            +            +            +            +            +            +            +            +            +
  000       +  000       +  000       +  000       +  000       +  000       +  000       +            +            +            +            +  000       +
  0k0       +  0 0       +  0 0       +  0 0       +  0 0       +  0 0       +  000       +            +            +            +            +  000       +
  000       +  0 0       +  000       +  000       +  000       +  000       +  000       +            +            +            +            +  000       +
  000       +  0 0       +  000       +            +            +            +            +            +0000        +0000        +0000        +0000        +
00000       +000 0       +00000       +            +            +            +            +            +0000        +0000        +0000        +0000        +
00000       +0   0       +00000       +            +            +            +            +            +0000        +0000        +0000        +0000        +
00000       +00000       +00000       +            +            +            +            +            +0000        +0000        +0000        +0000        +
++++++++++++++++++++++++++++++++++++++++++++++++++++++++++++++++++++++++++++++++++++++++++++++++++++++++++++++++++++++++++++++++++++++++++++++++++++++++++++
            +            +            +            +            +            +            +            +            +            +            +            +
         666+         666+         666+            +000000000   +000000000   +000000000   +000         +000         +000         +000         +000         +
         666+         6 6+         666+            +000000000   +0 0000000   +000000000   +0 0         +000         +000         +0 0         +000         +
         666+         666+         666+            +000000000   +000000000   +000000000   +000         +000         +000         +000         +000         +
            +            +            +            +      000   +      000   +      000   +            +            +            +            +            +
  000       +  000       +  000       +  000       +  000 000   +  000 000   +  000 000   +            +            +            +            +  000       +
  000       +  000       +  000       +  0 0       +  000 000   +  0k0 000   +  000 000   +            +            +            +            +  000       +
  000       +  000       +  000       +  000       +  000 000   +  000 000   +  000 000   +            +            +            +            +  000       +
  000       +  000       +  000       +            +      000   +      000   +      000   +            +0000        +0000        +0000        +0000        +
00000       +00000       +00000       +000         +000000000   +000000000   +000000000   +000         +0000        +0rr0        +0rs0        +0000        +
00000       +0 000       +00000       +000         +000000000   +000000000   +000000000   +000         +0000        +0rr0        +0rr0        +0000        +
00000       +00000       +00000       +000         +000000000   +000000000   +000000000   +000         +0000        +0000        +0000        +0000        +
++++++++++++++++++++++++++++++++++++++++++++++++++++++++++++++++++++++++++++++++++++++++++++++++++++++++++++++++++++++++++++++++++++++++++++++++++++++++++++
            +            +            +            +            +            +            +            +            +            +            +            +
         666+         666+         666+            +000000000   +000000000   +000000000   +000         +000         +            +            +            +
         666+         6 6+         666+            +000000000   +0ggggggg0   +000000000   +0 0         +000         +            +            +            +
         666+         6 6+         666+            +000000000   +0000000g0   +000000000   +000         +000         +            +            +            +
            +            +            +            +      000   +      0g0   +      000   +            +            +            +            +            +
            +            +  000       +  000       +  000 000   +  000 0g0   +  000 000   +            +            +            +            +            +
            +            +  000       +  0h0       +  000 000   +  000 0h0   +  000 000   +            +            +            +            +            +
            +            +  000       +  000       +  000 000   +  000 0 0   +  000 000   +            +            +            +            +            +
            +            +            +  000       +      000   +      0 0   +      000   +            +0000        +0000        +0000        +0000        +
000         +000         +000         +00000       +000000000   +0000000 0   +000000000   +000         +0000        +0 r0        +0  0        +0000        +
000         +0 0         +0 0         +0 0         +0 0000000   +0       0   +0 0000000   +0 0         +0 00        +0hr0        +0rr0        +0000        +
000         +000         +000         +000         +000000000   +000000000   +000000000   +000         +0000        +0000        +0000        +0000        +
++++++++++++++++++++++++++++++++++++++++++++++++++++++++++++++++++++++++++++++++++++++++++++++++++++++++++++++++++++++++++++++++++++++++++++++++++++++++++++
            +            +            +            +            +            +            +            +            +            +            +            +
         666+         666+         666+            +000000000   +000000000   +000000000   +000         +000         +            +            +            +
         666+         666+         666+            +000000000   +000000000   +000000000   +0 0         +000         +            +            +            +
         666+         666+         666+            +000000000   +000000000   +000000000   +000         +000         +            +            +            +
            +            +            +            +      000   +      000   +      000   +            +            +            +            +            +
            +            +  000       +  000       +  000 000   +      000   +      000   +            +            +            +            +            +
            +            +  000       +  0h0       +  000 000   +      000   +      000   +            +            +            +            +            +
  000       +  000       +  000       +  0h0       +  000 000   +      000   +      000   +            +            +            +            +            +
  000       +  000       +  000       +  0h0       +  000 000   +      000   +      000   +            +0000        +0000        +0000        +0000        +
00000       +00000       +00000       +00000       +000000000   +000000000   +000000000   +000         +0000        +0000        +0000        +0000        +
000         +000         +000         +000         +000000000   +000000000   +000000000   +000         +0000        +0000        +0000        +0000        +
000         +000         +000         +000         +000000000   +000000000   +000000000   +000         +0000        +0000        +0000        +0000        +
++++++++++++++++++++++++++++++++++++++++++++++++++++++++++++++++++++++++++++++++++++++++++++++++++++++++++++++++++++++++++++++++++++++++++++++++++++++++++++
            +            +            +            +            +            +            +            +            +            +            +            +
            +            +            +            +            +            +000         +000         +000         +            +            +            +
            +            +            +            +            +            +000         +0 0         +000         +            +            +            +
            +            +            +            +            +            +000         +000         +000         +            +            +            +
            +            +            +            +            +            +            +            +            +            +            +            +
            +            +            +  000       +            +            +            +            +            +            +            +            +
            +            +            +  000       +            +            +            +            +            +            +            +            +
  000       +  000       +  000       +  000       +  000       +            +            +            +            +            +            +            +
  000       +  0r0       +  0 0       +  0 0       +  000       +            +            +            +            +            +            +            +
  000       +  000       +  000       +  000       +  000       +            +            +            +            +            +            +            +
            +            +            +            +            +            +            +            +            +            +            +            +
            +            +            +            +            +            +            +            +            +            +            +            +
++++++++++++++++++++++++++++++++++++++++++++++++++++++++++++++++++++++++++++++++++++++++++++++++++++++++++++++++++++++++++++++++++++++++++++++++++++++++++++
000000000000+000000000000+000000000000+000000000000+000000000000+000000000000+000000000000+000000000000+000000000000+000000000000+000000000000+000000000000+
000000000000+000000000000+000000000000+000000000000+000000000000+000000000000+000000000000+000000000000+000000000000+000000000000+000000000000+000000000000+
000000000000+000000000000+000000000000+000000000000+000000000000+000000000000+000000000000+0 0000000000+000000000000+000000000000+000000000000+000000000000+
000000000000+000000000000+000000000000+000000000000+000000000000+000000000000+000000000000+000000000000+000000000000+000000000000+000000000000+000000000000+
000000000000+000000000000+000000000000+000000000000+000000000000+000000000000+000000000000+000000000000+000000000000+000000000000+000000000000+000000000000+
000000000000+000000000000+000000000000+000000000000+000000000000+000000000000+000000000000+000000000000+000000000000+000000000000+000000000000+000000000000+
000000000000+000000000000+000000000000+000000000000+000000000000+000000000000+000000000000+000000000000+000000000000+000000000000+000000000000+000000000000+
000000000000+000000000000+000000000000+000000000000+000000000000+000000000000+000000000000+000000000000+000000000000+000000000000+000000000000+000000000000+
000000000000+000s00000000+000000000000+000000000000+000000000000+000000000000+000000000000+000000000000+000000000000+000000000000+000000000000+000000000000+
000000000000+000000000000+000000000000+000000000000+000000000000+000000000000+000000000000+000000000000+000000000000+000000000000+000000000000+000000000000+
000000000000+000000000000+000000000000+000000000000+000000000000+000000000000+000000000000+000000000000+000000000000+000000000000+000000000000+000000000000+
000000000000+000000000000+000000000000+000000000000+000000000000+000000000000+000000000000+000000000000+000000000000+000000000000+000000000000+000000000000+
++++++++++++++++++++++++++++++++++++++++++++++++++++++++++++++++++++++++++++++++++++++++++++++++++++++++++++++++++++++++++++++++++++++++++++++++++++++++++++